«Благо», «справедливость», «добродетель» являются категориями такой философской науки, как:	этика
 Работа "Экология животных", в которой рассматривается "естественная история" написана:	Элтоном Чарлзем
"Государство" написал	Платон
"Жизненная философия", "житейская мудрость"	позволяет человеку осуществлять выбор, следуя избранным идеалам
"Категории" могут рассматриваться как	все вышеперечисленное
"Не поступай так, как ты не хотел бы, что они поступали по отношению к тебе" -- это одна из формулировок:	золотого правила нравственности
"Прекрасное", "возвышенное", "искусство" являются категориями такой философской науки, как:	эстетика
"Симулякр" это	"псевдовещь", тип знаков,который может только выполнять отсыл к иному значению
"Сущность", "действительность", "причина", "субстанция" являются категориями такой философской науки как	онтология
...Homo sapiens...	Первичноротые
«Демассификация» цивилизации, которую отражают средства массовой информации, влечет за собой скачок объема информации, которой люди обмениваются друг с другом, считает Э. Тоффлер. Это способствует тому, что:	люди нуждаются в информации, чтобы предвидеть, как другие люди будут относиться к ним самим
«Естественная теология» это:	богословие, доступное человеческому разуму без божественного откровения 
«Истина», «утверждение», «отрицание», «познание» являются категориями такой философской науки, как:	гносеология
«Классической» концепцией истины считается ее восприятие как:	соответствие мышления предмету 
«Метанарратив» это:	концепция, обосновывающая основания других концепции
«Разумный эгоизм» основан на убеждении, что:	разумно следовать таким общим правилам, которые удовлетворили бы эгоизм каждого верно
«Теология» является	синонимом «богословия»
«Экологическая культура» включает в себя	все вышеперечисленное верно
Августин в числе прочих определяет следующие «составляющие» мастера, которые сотворены Богом:	тело, душу, талант
Августин иллюстрирует идею о сотворении неба и земли Богом, противопоставляя их сотворение:	созданию вещи мастером
Августину не нравится идея о том, что Бог сотворил землю и небо своими словами, облеченными в телесную форму, поскольку:	это означает, что до сотворения земли и неба уже было телесное существо, могущее их произнести
автор эссе философское мировоззрение	Макс Шелер
Автором классических этических произведений "Евдемова этика" и "Большая этика" является 	Аристотель
Автором работы "Ступени органического и человек" является один из основоположников философской антропологии	Х. Плеснер
Автором работы «Что такое глобализация» является:	Ульрих Бек
Автором эссе "Философское мировозрение" является	М. Шелер
Анализа современной культурной ситуации, представленный в работах Ю.М.Лотмана и М.Маклюэна, оказался общим в том, что они	концентрируются на видах коммуникации, определяющих доминирующий тип культуры
Античное представление о гармонии подразумевало	совершенное соотношение, соразмерность частей предмета и всего мороздания
Антонимом понятия космос является 	"хаос
"
Антропология возникает	в Новое время
Аристотель утверждал, что семья- это	общение, естественным путем возникающее для удавлетворения повседневных надобностей
Аристотелю принадлежит знаменитое учение о добродетели как	середине между избытком и недостатком страсти верно
Большая часть цивилизаций, называемых А. Тойнби, может быть символически обозначена посредством	исповедуемой религии
В 1952 году американские антропологи опубликовали труд, посвященный разбору многих имеющихся определений культуры.Этот сборник называется	культура: критический обзор понятий и определений
В XX в. исследования в области философской антропологии обуславливаются влиянием достижений в области:	всем вышеперечисленным
В более совершенной религии присутствуют элементы прошлого, законы предшествующей религии, потому что:	люди консервативны и нуждаются в объяснении на основании привычных им понятий
В доказательство, что пространство не есть эмпирическое понятие, Кант приводит такой аргумент:	можно представить пустое пространство, но невозможно представить отсутствие самого пространства верно
В интерпретации Х. Ортега-и-Гассета "универсум" как предмет философии выступает	самодостаточным целым
В истории европейской науки одну из ключевых ролей в становлении исследования культуры сыграли	немецкие мыслители И.Кант, И.Гердер, Г.В.Ф.Гегель
В каких диалогах Платона было заложено основание для онтологического доказательства бытия бога?	"Государство" и "Парменид"
В книге «Третья волна» Э. Тоффлер предложил периодизацию историко-культурного процесса в зависимости от:	технологических инноваций
В культуре европейского средневековья природа человека находила свое выражение в 	празднике и карнавале
В мировоззрении античности человек проблематизируется	постольку, постольку он является элементом космоса
В настоящее сближение философии и науки на основе идеи универсальности знания осуществляется в форме	разработки методологии
в научное обращение термин "история" ввел древнегреческий мыслитель и историк	Геродот
В понимании Г.Риккерта, объект культуры:	возникает из объекта природы благодаря присоединению к нему ценности
В предполагаемом сценарии межцивилизационной войны, описанном С. Хантингтоном, Россия:	в конце концов в качестве полноправного члена вступает в НАТО
В своей интерпретации религии К.Маркс отталкивался и критически переосмыслял учение:	Л.Фейербаха
В своем учении о пространстве И.Кант, как он полагал, обосновал такую науку, как:	геометрия
В современной науке нет единого общепринятого определения понятия культуры, потому что	конкретное определение понятие культуры зависит от других базовых понятий
В список базовых общих потребностей, благодаря которым жизнь людей актуализируется в виде различных форм совместной деятельности, не входит потребность в...	самореализации
В средневековой философии важный аспект познания истины в том, что	все сущее сотворено богом
В Средние века в Европе было распространено христианское миропонимание, поэтому в число важных проблем философии входили:	всё, связанное с религией, богом и тд
В Средние века на первый план вышла проблема свободы от:	греха
В сферы общественной жизни входят:	все, кроме творческой
В теории Ж.Бодрийяра «потребление» в современной культуре рассматривается как	система коммуникации и структура отношений в обществе
В терминологии И.Канта, «антропология» это:	всеобщая систематическая наука о человеке
В терминологии И.Канта, «естественная религия» это:	религия, в которой для понимания нравственных заповедей не требуется откровения
В условиях современности одним из основных вопросов экологии становится	глобальный экологический кризис верно
В условиях современности ситуация риска разворачивается в следующих областях	во всем вышеперечисленном и еще во многом другом
В учении Иоахима Флорского четко видится тенденция, нашедшая свое место в учениях утопистов XVI-XVII веков, которые, в свою очередь, непосредственно предшествовали возникновению исторического мировоззрения. Это – ...	социальная заинтересованность
В чем причина того, что работа И.Ньютона называлась «Математические начала натуральной философии», К.Линнея – «Философия ботаники», а Ж.Б.Ламарка – «Философия зоологии», и они считались частью философии?	они все рассматривали основные категории и проблемы своих областей верно
В число важнейших аспектов существования семьи, по Гегелю, входят:	все вышеперечисленное
В число направлений, исследовавших сущность человека в XX в., можно включить	структурализм
В число направлений, исследовавших сущность человека в XX в., можно включить:	все вышеперечисленное
В экзистенциализме Ж.-П. Сартра понятия человек и свобода связаны следующим образом	бытие человека и есть свобода
В эпоху Возрождения образец для формирования нового отношения к природе - 	античная культура
В эстетическом опыте произведение искусства не отличается принципиально от красоты природы так как	впечатление связано с произведением вне зависимости от того, кто создал данный объект
В.С. Соловьев полагал, что особенностью человека, делающей из него нравственное существо, является	разумная убежденность в значимости идеи добра
В.С. Соловьев утверждает, что	нравственность невозможно свести к психологии
В.С. Соловьев формулирует важную для всей этики проблему свободы воли и детерминизма, которая заключается в том, что	все действия человека имеют естественную причину, поэтому нельзя говорить о нравственности верно
Важная характеристика истины в том, что она:	остается неизменной
Важнейшая специфическая особенность и проблема человека, в методологическом смысле центральная для философской антропологии:	он – существо многомерное, не выразимое одним понятием
Важнейшая теоретическая проблема взаимоотношения религии и философии, согласно С.Л.Франку, такова:	может ли философия не быть рациональной?
Важнейшая цель метода, предлагаемого Декартом, в том, что он:	позволяет пользоваться собственным разумом наилучшим образом
Важнейший вклад Фрэнсиса Бэкона	развитие индуктивного метода
Важнейший контекст средневекового религиозного понимания человека:	иерархия отношений земного и небесного
Важнейший методологический принцип исследования медиа в том, что	медиа влияют на содержание передаваемого сообщения
Важнейшим выводом исследования Кантом чувственного восприятия с его формальной стороны, является то, что формами чувственного созерцания являются:	пространство и время верно
Важнейшим моментом в смене коммуникативных моделей человечества стало	все вышеперечисленное верно
Важнейшим стимулом построения антропологии для М.Шелера стало такое философское учение, как:	феноменология верно
Важное методологическое замечание, существенное для построения философской антропологии и сформулированное М.Шелером, таково:	ученые исследуют происхождение человека, не отвечая на вопрос, что он по сущности 
Важность природы для человека в том, что она является источником:	все вышеперечисленное
Важность ценностей как части структуры мировоззрения определяется тем, что они:	выражают основные потребности и интересы человека верно
Важным для содержания исторического факта является сопоставление исторического процесса и ...	уровня развития конкретного общества
Великой минутой в жизни человечества Тейяр де Шарден называл осознание того, что	точка сосредоточения универсального стремления к жизни 
Вера по Канту, это	"уверенность в собственном спасении
"
Вико рассматривает исторический процесс в качестве явления, в котором не просто происходят некие факты, но люди творят языки, государства, нравы. То есть, он:	видит в истории историю возникновения и развития человеческих обществ и их институтов
Во взаимодействии человека с другими людьми формируются:	сознание, речь, трудовые навыки
Впервые церковь институализируется во времена:	упадка Римской империи
Все ли эстетические категории носят оценочный характер?	все
Выберите правильное утвержение	философии как никакой другой форме освоения мира человеком, присущ методологический плюрализм
Выберите суждение, лучше всего отражающее позицию Канта:	значимость человека как предмета исследования настолько велика, что знание о нем может назваться знанием обо всем мире верно
Высшее содержание научной деятельности, по В.С.Соловьеву, должно состоять в:	объяснении сущности и целей существования мира
Высшую критическую точку состояния наибольшей сложности вещества и развитости мышления Тейяр де Шарден называет:	точка омега
Выяснение причин возникновения и распространения представлений о богах икультовой практики является предметом исследования	философии религии
Г.В.Ф. Гегель утверждал, что в семье индивид, благодаря природному чувству любви, постигает свою общественную сущность. Он называл это:	непосредственной субстанциальностью духа
Г.-Г. Гадамер написал небольшую, но ключевую для понимания работу...	Истина и метод 
Гармония с окружающим миром характерна для традиционных культур, в то время как инновационные культуры зачастую вступают на путь борьбы " со стихией". Такой стала культура	Нового времени
Гегель считает, что женщина может быть образованной, однако:	она не способна обладать идеальным, не способна воспринимать философию и некоторые высшие науки
Гегель считает, что исходным пунктом брака является свободное согласие лиц составить одно лицо (семью), при этом:	теряется единичная личность каждого
Гегель утверждал, что в государстве нет любви, поскольку в нем	единство осознается в качестве закона
Главная критика Франком рационалистической философии истории заключается в утверждении, что две ее главные предпосылки ложны, поскольку:	история движется независимо от развития умственного развития, и жизнь человека от него зависит не всегда
Главное антропологическое произведение Макса Шелера называется	«Положение человека в космосе»
Главной стратегией современного капитализма является биополитика. Она предполагает, что необходимо:	проявлять интерес к человеку, во всей полноте его бытия, его жизни
Главным вопросом философии Иммануил Кант считал	Что такое человек?
Господство рационализма и прагматизма в современной эстетике связано:	с рационализмом и герменевтическим дискурсом кураторов и искусствоведов верно
Государство – сила, удерживающая людей от худших их проявлений. Так считал:	никто из вышеперечисленных
Гуманизм эпохи Возрождения, в отличие от средневековых мыслителей, полагали, что:	природное и божественное в человеке находятся не в противоборстве, а в гармонии
Два основных прямых последователя Вико в XIX веке:	И.Г. Гердер и И.Г. Фихте
Двигателем буржуазной цивилизации является:	классовый конфликт верно
Дж.Э. Мур критикует этику, которая превращает «добро» в некое естественное предметное свойство, что искажает понимание. Такой ход мышления он называет:	«натуралистической ошибкой» верно
Диалектика исходит из того,что	все вышеперечисленное
Диалектический метод был в новоевропейской философии обновлен:	Г.В.Ф.Гегелем
Для взаимодействия человека и культуры , производства объектов культуры и освоения ее употребляется такая пара терминов, как	опредмечивание и распредмечивание
Для Джамбаттисты Вико история – это:	непрерывное настоящее, представляющее собой становящееся новое общество
Для Джамбаттисты Вико история-это	процесс непрерывного линейного развития
Для понимания истины в Новое время характерен акцент	на самом познающем истину объекте
Для современного общества с его глобальным использованием техники, распространением человека по всей поверхности Земли, природа планеты становится	частью культуры
Для современной культуры обязательным условием возможности потребления, по Ж.Бодрийяру, является:	автономия вещей в качестве знаков
Для того, чтобы отождествить медиареальность и современное общество, необходимо представление об обществе как	форме, системе коммуникации
Для христианства исторический процесс одинаков, его процесс для всех един. Это происходит потому, что:	все люди и все народы вовлечены в осуществление божественных предначертаний верно
Для этики имеют значение не поступки и убеждения, а знание и аргументы; обычные критерии истинности, основанные на фактах, не применимы к ценностным высказываниям – это позиция	Дж.Э. Мура верно
Договор, согласно Т. Гоббсу, считается нарушенным, если:	имеет место несправедливость, т.е. невыполнение его условий
Доказательство того, что бог остается высшим добром, несмотря на существование зла, называются	теодицея
Духовность и аскетизм поддерживается и пропагандируется официальной культурой:	Средневековья
Духовный опыт человека может определять идейно-смысловое, ценностное единство общества, благодаря которому экономические, социальные и политические различия...	примиряются
Единственным направлением авангардного искусства, которое наследует идее геометрической гармонии, У.Эко называет:	абстрактное искусство
Если мы определим красоту как гармонию, что, в таком случае, будет условием красоты предм...	соразмерность форм предмета
Если учесть, что природа порождает человека, постоянно присутствует в нас и в нашей жизни, является важной составляющей многих окружающих нас предметов, а близость человека к природе – явное благо, то отрыв от природы будет значить:	смерть
Ж.-Ж.Руссо говорит, что не может быть причинен ущерб там, где отсутствует собственность, и называет это:	аксиомой Локка
Ж.-Ж.Руссо считает, что равенство исчезло, и появилась собственность только тогда, когда:	один человек стал нуждаться в помощи другого
Ж.-Ж.Руссо утверждает, что древние люди сами «надели ярмо» на себя и своих потомков, доставляя себе разнообразные удобства,...:	которые стало мучительно потерять
Ж.-П. Сартр утверждал, что «первым делом экзистенциализм отдает каждому человеку во владение его бытие и возлагает на него полную ответственность за существование». Значит ли это, что человек имеет право заботиться только о себе?	нет: по Сартру, неся ответственность за свой собственный выбор, мы как бы создаваем образ человека, каким он должен быть. верно
Желательным состоянием социума в условиях современности с ее экологическими кризисами, глобальным использованием техники и распространением массовой культуры потребления является	устойчивое равновесие
Завершите мысль У.Бека: в условиях глобальной культуры современности люди есть то	что они покупают
Закончите знаменитую фразу Аристотеля, открывающую его этическое сочинение: «Всякий человек от природы стремится к …	благу
Закончите знаменитый афоризм М.Маклюена: Метод коммуникации	и есть само сообщение
Знаменитая первая попытка свести представления о боге к сущности и проблемам человеческого существа принадлежит:	Л. Фейербаху
Знание отождествлял с добродетелью:	сократ
Золотое правило нравственности содержит в себе требование:	взаимности
И. Кант является автором строгой этической концепции, которая выражена им в нескольких трудах, в том числе в	"О мнимом праве лгать из человеколюбия"
И.Кант полагал, что наше познание начинается с чувственного опыта	однако, до всякого познания в душе есть форма познания верно
И.Кант полагал, что человек и есть самый главный предмет в мире, к которому все знания и навыки могут быть применены, потому что:	сам человек и является конечной целью
И.Кант утверждает, что для того, чтобы считать нечто прекрасным, нам требуется	ничто из перечисленного выше 
И.Кант формулирует следующее определение прекрасного:	вещь, о которой мы судим без всякого интереса верно
Й.Хейзинга в своих исследованиях показывает, что многие феномены культуры подпадают под признаки игрового действия. Один из этих признаков:	все вышеперечисленные
Идеалы как часть мировоззрения выполняют функцию	ориентирующую
Идеология экологического движения является по преимуществу	антиглобалистской
Идея подчинения природы нуждам человека характерна для культуры	Нового времени
изначальный смысл слова культура	возделывание
Институциональность государства неочевидна, поскольку...	первобытные общества вообще не имели никакого государства
Интеллектуальное и эстетическое освоение мира через прекрасное человеческое тело впервые реализовалось:	в искусстве античности
Исследование общих моделей мысления и , как следствие, языка как способа упорядочевания мира,становиться важным для такого направления	структурализм
Истинные и вечно тождественные самим себе сущности Платон называл:	идеи
Историки христианства относили апокалиптический момент истории к:	все вышеперечисленное
Исторически сложившийся образ нравственного поведения определенной социокультурной группы называется:	этос
История древних греков не легенда, а исследование, и именно поэтому она не теократична, а - ...	гуманистична
История получила распространение в период мировоззренческого кризиса. Свою очевидность утрачивает:	истина мифа
Источник экологических проблем XX в., варварского отношения к природе:	антропоцентризм Нового времени
Исходное значение слова "культура"	"возделывание"
Итальянский философ У.Эко находил возможность назвать «открытым произведением» и современное искусство, и современную рекламу, потому что	в современном искусстве и рекламе предполагается активная роль зрителя верно
К XVI веку идея творения и спасения меняется на идею...	творчества
к естественнонаучной антропологии не относиться(тся, долбоеб) исследование	различных культур и исторических судьбы
К какому подразделению классификации не относиться Homo sapien	первичноротые
К категориям гносеологии относят	ни одна из перечисленных
К области эстетики относится вопрос:	является ли красота свойством самой вещи или объективно прекрасного или безобразного не существует?
К областям философии (философским наукам) не относится:	поэтика
К первобытной форме религии относят:	фетишизм
К первому виду «перепадов» в развитии идеи Красоты в массмедиа У.Эко относит:	разнообразие соседствующих моделей красоты в каждый период
К философии религии относятся	все вышеперечисленное верно
Как возникает недоверие к метасценариям в современной культуре?	развитие истории приводит к тому, что истины, казавшиеся несомненными, ставят под сомнение
Как возникает недоверие к метасценариям в современной культуре?	воздействие правоставного христианства, ислама, индуизма и Дальнего Востока на культуру Запада
Как удостовериться в истинности своего суждения?	опыт является единственным достоверным критерием истинности
Какая из перечисленных проблем представляет глобальную опасность, согласно У.Беку?	все вышеперечисленное
Какая из приведенных ниже формулировок относится к категорическому императиву Канта:	«Поступай так, чтобы ты всегда относился к человечеству и в своем лице, и в лице всякого другого так же, как к цели, и никогда не относился бы к нему только как к средству» верно
какая наука занимается исследованием культуры	культурология
какая пара эстетических категорий образована неправильно?	возвышенное-порочное
Какая позиция лучше всего отражает исходное отношение этики к человеку:	человек не является ни добрым, ни злым
Какая религия не входит в число мировых:	иудаизм 
Какая эстетическая категория может считаться основной?	«прекрасное» верно
Какие из перечисленных произведений принадлежат Аристотелю	все перечисленные
Какие из перечисленных философов относятся к философскому прагматизму?	Чарльз Сандерс Пирс верно
Какие качества характеризуют человека-представителям массовой культуры?	все вышеперечисленное
Какие положения, по Канту, являются основополагающими для нравственности, и поэтому требуют своего доказательства на основании опыта и примеров?	ни одно из перечисленных
Какие социальные события и идеи не способствовали окончательной смене взгляда на историю в Европе 	ничего из вышеперечисленного
Какова, по Р. Ингардену, роль реального предмета для эстетического переживания?	эстетическое переживание иногда начинается c наблюдения реального предмета верно
Каково соотношение эстетического опыта и художественного опыта?	художественный опыт – разновидность эстетического
Каково, по В.С. Соловьеву, положение этики среди других дисциплин?	содержательно она связана с религией, а формально – с теоретическою философией верно
Какого из приведенных ниже принципов нет в списке правил, предлагаемых Декартом в качестве основных правил метода:	упражнять рассудок, не утомляя сильно воображение верно
какого рода зание, с позиции В.С.Соловьева, составляет предмет философии?	абсолютная истина
Какое из данных суждений справедливо относительно эстетического опыта?	для эстетического опыта не требуется, чтобы чувственные данные были представлены в полном виде и были соотносимым с тем или иным реальным объектом верно
Какое из перечисленных качеств характерно для эстетического опыта?	уникальность переживаний
Какое из перечисленных ниже религиозных движений возникло гораздо раньше ХХ в.	все вышеперечисленные возникли в ХХ в.
какое из перечисленных свойств не принадлежит к эстетическим категориям?	идея причинно-следственной связи между явлениями
Какое из перечисленных слов может обозначать мир в целом?	все вышеперечисленные
Какое событие лишило человека доверия к окружавшей действительности и дало начало новому витку развития истории как науки?	падение Римской империи
Какое соотношение терминов правильно?	этика – это раздел знания, а мораль – предмет этого знания верно
Какое суждение лучше всего отражает позицию Х. Ортега-и-Гассета?	человечество обращает внимание всегда на наиболее близкие для него истины
Какое суждение о строении эстетического опыта верно?	эстетический опыт является сложным процессом с характерным для него строением
Какой вид истины отсутствует в классификации Вл.Соловьева?	относительная
Какой из перечисленных ниже признаков, по Г.Риккерту, принадлежит природе:	все вышеперечисленные
Какой из перечисленных предметов исследования не относится к философии религии?	исторические формы религии
Какой из перечисленных элементов входит в определение высшего человеческого блага у Аристотеля?	все вышеперечисленные
Какой из перечисленных элементов присутствует в современном научном понятии культуры:	все вышеперечисленное
Кант является автором строгой этической концепции, которую описал в книге	О мнимом праве лгать из человеколюбия
Кантовское понимание автономии человека как нравственного существа значит	способность самому предписывать себе моральный закон
Кем сформулированы следующие четыре вопроса «1. Что я могу знать? 2. Что я должен делать? 3. На что я смею надеяться? 4. Что такое человек?»	И.Кантом
Коль скоро, по Дж.Э.Муру, «благо» есть простое качество, относительно него осмысленно ставить только такие вопросы:	существуют ли причинная связь каким-либо предметом и теми предметами, которые имеют качество «благо»
Концепция, изложенная английским философом Дж.Э. Муром, с которой начинают историю нового этапа англо-американской этики, именуется	метаэтика
Критикуя современную культуру Европы за безнравственность, Х. Ортега-и-Гассет имеет в виду, что	современное общество не придерживается никакой моральной теории или ценности
Кто из перечисленных мыслителей не относится к философской антропологии:	Освальд Шпенглер верно
Кто из этих авторов не был представителем психоанализа?	Ж.Батай
Кто из этих двух философов не признает за человеком первостепенной роли:	оба
Культуру иногда называют инобытием человека. Причина в том, что	культура – это результат деятельности человека в предметном мире
Латинское по происхождению слово «мораль» было введено в философию как	аналог и перевод слова «этика» 
Латинское слово «medium», корень которого есть в словах «медиасреда», «медиареальность», значит:	«находящееся посреди»
М.Шелер утверждал, что особое положение человека:	не может быть определено без учета выводов естественных наук
М.Шеллер отмечает, что исследование природы и определение ее законов непосредственно зависит от восприятия органами чувств	повторяющихся явлений
Макс Шелер вошел в историю философии как 	создатель философской антропологии
Манифестом экзистенциализма считается работа Экзистенциализм - это гуманизм, написанная 	Сартр
Марксизм совершенно прав в том, что называет идеологию извращенной, ложной формой общественного сознания. Это связано с тем, что 	она отражает интересы не общества в целом, а только какой-то его части
Массовизация средств обмена информацией является важнейшей чертой коммуникации человечества в:	XXI в.
Метафизическая точка зрения исходит из того, что	Сущность всякой вещи изначально неизменна
Мировоззрение включает в себя осознание отношения:	все вышеперечисленное
Мировоззренческая позиция, согласно которой человек является основным существом в мире и важнейшим предметом исследования:	антропоцентризм
Множество определений культуры в истории философии связано с тем, что:	Понятие природы понималось по-разному в разные времена
Можно ли утверждать, что мы достигли полного понимания того, что такое человек	среди ученых и философов отсутствует консенсус...
Монополия государства на насилие вместе с сосуществованием в условиях современности множества различных взглядов на жизнь и ценностей, имеет следствием	возрастание роли индивидуальной и групповой агрессивности
Мы далеко не всегда знаем истину, но ее важно знать, потому что она:	всегда имеет к нам отношение
Мысль Бердяева о том, что философское познание зависит от опыта человека, значит, что философия зависит от:	опыта радикального преобразования действительности
Н.Кондорсе написал труд, посвященный обоснованиям неизбежности совершенствования общества, который называется	эскиз исторической картины
На какой возможный риск лжи во спасение указывает Кант?	ты станешь виновником смерти человека, потому что солгав наугад, случайно назовешь его правильное местоположение верно
На латинском «истина»:	veritas
Наиболее важными направлениями в современной эстетике, исследующим структуру эстетического опыта, являются	обе эти традиции
Настаивая на том, что поэты должны быть изгнаны из идеального государства, Платон исходил из того, что инструмент познания это:	мышление
Насчитывается более 170 определений культуры. Знаменитая подборка этих определений принадлежит	американским антропологам А. Креберу и К. Клакхону
Началу философской антропологии было положено в трудах	никого из перечисленных
Непременным условием устойчивости, и безопасности общества является:	согласование интересов множества групп, различных по роду деятельности, ценностям, образу жизни
Ниже перечислены четыре основных вопроса философии "во всемирно-гражданском значении", как они даны И. Кантом в его "Логике". К камому из данных четырех вопросов могут быть сведены остальные	"Что такое человек?"
Нормативный элемент государственного управления необходим, но он может быть малоэффективен, если	нет принуждения, легального использования силы
О чем сообщает появление в XIX веке понятия «нация»?	о том, в это время появляется огромное число людей, активно заявляющей о своей социальной позиции, зарождаются общности, воспринимающие себя как единую силу
Областью философии, предметом которой является общество, является	социальная философия
Общение-это	универсальная форма бытия людей, выражающаяся в их взаимодействии
Общество-это динамическая, саморазвивающаяся система. Это означает, что	способна, серьезно изменяясь, сохранить в то же время свою сущность и качественную определенность
Объяснение религии как формы запрета и подавления человеческих естественных влечений характерно для:	З. Фрейда
Один из исходных принципов феноменологической теория познания таков:	наши знания происходят из опыта
Одним из первых сформулировал представление о человеке как о субъекте познания:	Декарт
Одним из первых термин «постмодерн» ввел в философский оборот:	Ж.-Ф.Лиотар
Одним из центральных объектов исследования Ж.Бодрийяра в книге «Система вещей» является:	функциональность вещи в традиционной культуре и размытие ее функциональности в современной
Одно из классических определений истины, идущее от средневековья	истина есть соответствие ума и вещи
онятие о гармонии вещи исходит из предпосылки, что	вещи могут иметь объективные эстетические свойства
Опасной причиной межцивилизационной войны, С. Хантингтону, является:	изменение расстановки сил между стержневыми странами разных цивилизаций
Описывая основные черты человеческого рода, И.Кант практически сразу переходит к анализу гражданского общества. Причина в том, что:	Кант присоединяется к тезису, что человек предназначен быть членом общества по своей природе верно
Осмысление отдельных компонентов эстетического опыта начинается	в древних цивилизациях Востока и в античной Европе
Основанием для эстетического опыта являются чувственные объективные ощущения. Однако, как указывал, например, М.Бердсли их одних недостаточно, они должны дополняться:	субъективным переживанием
Основания доказательсв бытия были бога заложены ещё у:	Платона
Основателем и одним из важнейших представителей феноменологии был	Э.Гуссерль
Основателем систематической этики считается	Аристотель
Основная ценность науки истории, по Р. Коллингвуду, в том, что она может дать ответ на вопрос, что представляет собой человек. Это происходит потому, что история может определить	что человек смог сделать за прошедшие столетия
Основная ценность философского исследования истины в том, что 	этот поиск выражает саму энергию человеческого познания
Основное произведение И. Канта, посвященное эстетике и философии искусства (в современном их понимании) является:	«Критика способности суждения»
Основные этические категории это:	добро и зло
Основным и общим объектом исследования и религиоведения, и философии религии выступает	религия верно
Основным трудом французского палеонтолога и иезуита Тейяра де Шардена является работа под названием 	Феномен человека
Основоположник новоевропейской научной философии Рене Декарт написал	"Рассуждение о методе"
Особенность новоевропейской философии, которая существенно повлияла на становлении антропологии:	реабилитация человеческого тела верно
Особенность отношения философии к тому или иному мировоззрению того или иного общества в том:	все вышеперечисленное
Особенность философии по Г.-Г. Гадамеру в том, что	она вынуждена постоянно заниматься историей своих понятий
Особенность эстетики в том, что она изучает в первую очередь идеального субъекта восприятия и идеальное эстетическое отношение, а не конкретные произведения искусства. Причина в том, что:	основной подход эстетики – изучать принципиальные, важнейшие проблемы верно
Особенностью классического искусства является	активная позиция зрителя
Отличительной чертой религиозной философии является:	утверждение взаимодополнительности разума и веры для постижения истины верно
Отношение к природе как к совершенству, гармонии характерно для	античности
Парменид утверждал что "есть одно"	мыслить и быть
Первая в истории социальная группа, которая позиционировала свою самостоятельность и самодеятельность-это	буржуазия
Первое крупное произведение Вл. Соловьева, которое так и осталось незавершенным, называется:	"Философские начала цельного знания"
Первым семью в экономическом и индивидуалистическом понимании истолковал:	Дж. Локк
Первым указывает на фактический характер истории:	Дж. Вико
Переход к современному финансовому капитализму не смог бы состояться, если бы западными странами не осуществлялась политика	колониализма и неоколониализма
Периодизация техники, основанная на выделении доиндустриальной, индустриальной и постиндустриальной стадии, принадлежит:	Э. Тоффлеру
Платон называет подлинными философами тех, кто	любит изучать истину
Платон полагал, что нравственное совершенство человека возможно только:	в идеальном государстве
Платон характеризовал мнение как	нечто среднее между знанием и незнанием
По Бердяеву практическая задача философа в том, чтобы	изменять социальную реальность
По Г.-Г. Гадамеру, то, что естественные науки стали играть лидирующую роль, приводит к:	доминированию логики и логического анализа языка
По Г.-Г. Гадамеру, формирование понятий как единиц человеческого мышления:	обусловлено уже имеющимся языком и историей истолкования мира верно
По Дж.Э.Муру, важнейшим вопросом этики является следующий:	Что обозначает слово «добро»? 
По Й. Хейзинге, исследование и признание игры требует признания существования:	духа
По М.Шелеру, «инстинкт — более примитивная форма психического бытия и процесса, чем сложные душевные образования, определенные ассоциациями». На каком основании он так утверждает?	существо, имеющее только инстинкт, менее свободно от окружающего мира верно
По мнению автора, духовный опыт помогает раскрыть представления об основных идеалах, имеющих...	универсальную значимость для общества
По мнению автора, духовный опыт помогает раскрыть представления об основных идеалах, имеющих...	значимость, сопоставимую с религиозными догмами
По мнению Г.В.Гегеля подлинно свободное государство, где прогресс достигнут, и все являются свободными-это	Пруссия
"По Н.А. Бердяеву, особенность существования философии в высших учебных заведениях в том, что она вынуждена
"	доказывать правильность доминирующей политической идеологии
По Р. Ингардену, в эстетическом переживании некоторые реальные свойства предмета могут не замечаться, потому что	такие свойства мешают целостности эстетического восприятия
По С. Хантингтону, более стабильным может оказаться мир, в котором:	ядерным оружием обладают одно или два ключевых государства в каждой цивилизации
По С.Л. Франку «ложный» тип философии истории заключается в том, чтобы понять:	цель исторического развития
По Т.Гоббсу, началом справедливости служит соглашение. А началом благодарности?	милость
По утверждению Аристотеля, наука о благе и нравственности	практическая
По Ф.Энгельсу, исходная установка материализма состоит в том, что	правильный взгляд на мир формируется только при соблюдлении законов логики
По Ф.Энгельсу, налоги возникают там, где, в силу раскола общества на классы, необходимо:	обеспечивать публичную власть
По Фрейду, роль очеловечивания природы в ранних религиях в том, что она представляет собой	возможность понять ее и каким-то образом реагировать на нее верно
По Х. Ортега-и-Гассету, нужно помнить, что:	может случиться, что настоящая истина не найдет выражения в той или иной эпохе, или её смогут понять только несколько человек
По Шелеру, философское познание в естественных науках определяет	границы применения данных наук
По Шеллеру философское познание в естественных науках определяет	Важнейшие предспосылки и основы данных наук
По Э. Тоффлеру, основное требование, которое предъявляется в последние века по отношению к новым технологиям – это...	возможность работать на экономический рост и военную мощь
Под «восстанием масс» Х. Ортега-и-Гассет имел в виду:	кризис культуры в результате распространения мировоззрения серой посредственности
Под антропоцентризмом в философской литературе понимается	порядок мира, при котором человек дает миру правило и закон
Подлинная активность человека, в преставлении Э.Фромма, это:	испытывать непосредственный интерес к миру
Позитивная философия Огюста Конта и его последователей рассматривает человека как	часть социального организма, живущего и развивающегося по собственным законам
Поле производства в современном капитализме расширяется в связи с тем, что	технический прогресс также включает в себя увеличение производства
Политическая сфера может быть оформлена только когда	возникла необходимость разрешения социально-стратовых противоречий
Понятие "порыва" у М.Шелера значит	хаотические силы природы
Порядок человеческого бытия носит общественный характер и представляет собой систему...	Во взаимодействии человека с другими людьми формируются:
Поскольку в Новое время познающий истину субъект рассматривается как самостоятельный, то большое значение приобретает:	отслеживание и избегание ошибок верно
Постиндустриальное общество предполагает деградацию эстетического вкуса и распространение массовой культуры в связи с	отсутствием интереса к подлинному искусству
Посткапиталистическое производство стремится к:	тотализации пространства человеческого бытия
Поступки, сообразные добродетелям, согласно Аристотелю:	приносят удовольствие сами по себе верно
Почему вопрос об истине остаётся открытым 	продолжается поиск наиболее удачного определения
Почему нельзя утверждать, что мы достигли полного понимания того, что такое человек?	среди ученых и философов отсутствует консенсус в понимании человеческой природы
Почему эстетическое суждение обычно носит оценочный характер?	оценка как реакция является естественной для человека
Появление философской антропологии как отдельной отрасли философского знания в начале XX в. связано с именем:	М.Шелера 
Представителем эстетики XX в., утверждавшим, что для эстетического опыта характерны интенсивность, внутренняя согласованность и стремление к завершенности, был	М.Бердсли
Примером симулякра может быть	рекламный образ верно
Принцип интенциональности сознания у Э.Гуссерля значит:	все вышеперечисленное верно
Проблема сочетания свободы и всеобщего закона причинности характерно для	Нового времени верно
Проводник хилиазма Иоахим Флорский предвещал наступление Царства Святого духа:	в 1260 году
Прогулка египетского фараона может считаться историческим фактом только в том случае, если:	фараон во время прогулки принял новое решение, могущее повлечь серьезные исторические последствия
Продолжите мысль Ж.-П.Сартра: «Для экзистенциалиста человек потому не поддается определению, что первоначально ничего собой не представляет. Человеком он становится лишь впоследствии…»	…причем таким, каким сделает себя сам верно
Продолжите фразу "Человек творит культуру"	и сам является ее творением 
Произведения, соответствующие римскому политическому могуществу и описывающие его создал следующий историк:	все вышеперечисленные
Противостояние философии и богословия можно, по Бердяеву, описать как	противостояние индивидуального и коллективного мышления
Р. Ингарден считал, что	оба ответа верные
Р. Коллингвуд исходит из того, что прошлое как специфический объект может быть познан при помощи:	ничего из перечисленного
Р. Коллингвуд написал фундаментальное исследование, посвященное историческому процессу и философии истории, которое называется:	"Идея истории"
Р.Ингарден утверждает, что эстетический опыт начинается со своеобразного игнорирования вопроса о реальности предметов. Это делается философом для того, чтобы:	отличить эстетическое отношение к предмету от познавательного верно
Работа 18 века, в которой человеческие взаимоотношения рассматриваются в качестве единства сил отталкивания(эгоизма) и притяжения (общности интересов), называется " О человеке". Кто ее автор?	К.Гельвеций
Работа известного американского философа Бердсли	Эстетика: проблемы философии критики
Работа известного американского философа М. Берсли, посвященная эстетическому опыту и его характеристикам, называется:	«Эстетический опыт»
Работу по философии религии которая отличается критическим и антропологическим взглядами на религию, написал Л. Фейербах. Она называется	"Лекции о сущности религии"
Работу, посвященную средствам массовых коммуникации и их влиянию на жизнь человека, написал Н. Луман. Она называется:	Реальность масс-медиа
Развивая свою культурологическую концепцию, Й.Хейзинга называл человека	homo ludens
Раскрывая значение истины как aletheia, Хайдеггер обращает внимание на такое исходное значение этого древнегреческого слова, как	раскрытие
Религиозная философия...	тесно связана с теологией, и использует философский понятийный аппарат для религиозного осмысления мира, а философскую религию- для интерпретации религиозного опыта
Решающим фактором, который определяет уникальность социокультурного организма, является:	преображающая сила народного духа
Робинзон Крузо пользуется орудиями труда, технологиями, трудовыми навыками, приобретенными им в обществе, что говорит о:	том, что деятельность человека никогда не бывает индивидуальной
Родоначальником концепции массовой культуры считается	Х.Ортега-и-Гассет
Родоначальником рационализма Нового времени принято считать	Р. Декарта
Роль государства – обеспечение...	безопасности и устойчивости общества
Роль сомнения, по Декарту, в том, что оно позволяет	все вышеперечисленное
Русская революция	продолжается уже больше ста лет
Руссо является автором исследования:	Об Общественном договоре, или Принципы политического Права
Ряд философов утверждает, что мир не может быть познан. По мнению Ф.Энгельса, эта позиция лучше всего опровергается:	практикой
С позиции З.Фрейда, предлагаемое религией учение о бессмертии	помогает справиться с осознанием пространственных и временных пределов исполнения желаний человека
С позиции Н. Лумана, в современной культуре отображение реальности происходит, в первую очередь, посредством.	новостей
С позиции Р. Коллингвуда, основной вопрос философии истории:	Как наука история познает прошлое?
С позиции Хайдегера, связь понимание истины с рациональностью приводит господству	метафизики
С развитием естественнонаучных знаний функция религии (роль представления о богах) все больше смещается, по З.Фрейду, в область:	нравственности
С точки зрения А. Тойнби, самое важное в истории XX в. это	воздействие западной цивилизации на другие
С точки зрения Д.Юма, причинно-следственную связь смешивают со случайносттью, и то, что мы видим, как одно явление прешествует другому, не доказывает, что первое-причина следующего. это подразумевает, что: 	1. это противоречит евангельской проповеди
С точки зрения И. Канта, суть эстетического отношения к предмету в	нашей в нем незаинтересованности
С точки зрения Канта, ложь всегда вредна, потому что	дискредитирует саму ценность правдивости верно
С точки зрения М. Шелера европейское понятие о человеке складывается из трех независимых друг от друга соста	человек как существо, порожденное обществом и культурой
С точки зрения М.Маклюена, жизнь человечества изменяет	любой новый метод и средство коммуникации
С точки зрения Н. Лумана, системой, производящей реальность в условиях современности является:	масс-медиа
С точки зрения Н.Лумана, склонность к самонаблюдению у современного человека развивает, скорее:	сфера развлечений
С точки зрения Парменида, исключительной деятельностью человека, направленной на познание истины, является:	мышление
С точки зрения Р. Коллингвуда, понять прошлое – не то же самое, что понять историю как науку. Поэтому чтобы понять, что такое история как наука	нужно иметь исторические знания и опыт рефлексии
С точки зрения Э.Гуссерля, законы логики и математики относятся к	феноменологическая редукция
С. Хантингтон утверждает, что в Совете безопасности ООН обязательно олжны быть постоянные представители	Африки, Латинской Америки и мусульманского мира
С.Л.Франк считает, что философское понятие о боге может заключать в себе идеи:	все вышеперечисленное
С.Л.Франк указывает, что определенная опасность философии для религии может быть в том, что	философское исследование устраняет таинственность природы божества
Самая известная формулировка категорического императива Канта содержит в себе:	все вышеперечисленное
Самая наглядная типология обществ предполагает разделение на 	письменные и бесписьменные
Сегодня под религией понимается	Мировоззрение или мировосприятие, а также поведение, опред. Верой в существование Бога
Слово «приматы» значит:	высшие
Собственность-это исторически сложившиеся отношения между людьми по поводу	присвоения и отчуждения жизненных благ
Современная эмпирическая антропология зародилась в том числе в трудах	М. Мосса
Согласно А. Тойнби, понимание истории народа или страны зависит от цивилизации, к которой они относятся, то есть:	от наименьшего необходимого исторического контекста
Согласно Августину, будущее и прошлое для людей существуют, благодаря тому, что	Бог создал и прошлое, и настоящее, и будущее
Согласно античной традиции, впервые слово «философия» употребил:	Пифагор верно
Согласно Аристотелю, возможно три образа человеческой жизни и три представления о счастье: направленный на удовольствия, государственный и созерцательный. Какой из них подвергается Аристотелем наибольшей критике?	направленный на удовольствия верно
Согласно Аристотелю, место бога в философии определяется тем, что он:	является источником всякого движения и конечной целью
Согласно Аристотелю, человек располагает таким «видом души», такой способностью, как:	разум
Согласно Г.-Г. Гадамеру, связи философского мышления с языком в том, что:	оно требует усилий по осознанию себя и мира, которому потом требуется найти выражение в языке верно
Согласно Г.Риккерту, явления культуры следует рассматривать:	не только в связи с заложенной в них ценностью, но и в их отношении к оценивающему существу
Согласно Гегелю, религия – это:	самосознание абсолютного духа, опосредованное конечным человеческим духом верно
Согласно Декарту, философский призыв преобразовать свои знания не подходит:	оба данных типа людей
Согласно Дж. Э. Муру, утверждать,что термин "добро" означает некий уникальный простой предмет мышления, значит:	правильно представлять себе "добро"
Согласно Ж.Бодрийяру, в современной культуре предмет потребления должен восприниматься как лишенный:	всех вышеперечисленных характеристик
Согласно Ж.Бодрийяру, особенность «знака» в том, что он	подразумевает существование отдельных субъектов, которые обмениваются знаками
Согласно Ж.-Ж.Руссо, люди могли получить понятие о взаимных обязательствах только тогда, когда:	человек научился объединяться с одними и остерегаться других людей
Согласно Ж.-Ф.Лиотару, метанарратив Нового времени это	обоснование того, что разум может познать мир исчерпывающим образом
Согласно З.Фрейду, религия относится к 	Психологическому аспекту культуры
Согласно знаменитому принципу экзистенциализма, сформулированному Сартром, существование человека предшествует сущности. Это значит, что:	следует признать, что человек существует, а любое определение, что такое человек, вторично
Согласно И. Канту, религия – это:	познание наших моральных обязанностей в виде божественных заповедей верно
Согласно Й. Хейзинге, игра	не требует рациональности для своего понимания
Согласно Й. Хейзинге, специфика исследования игры в человеческой культуре в том, что	оно пытается понять игру так, как воспринимает ее сам играющий
Согласно И.Канту, во всех показаниях быть правдивым, честным – это:	заповедь разума верно
Согласно И.Канту, говоря, что предмет красив, мы, на самом деле:	говорим о субъекте и его чувстве удовольствия 
Согласно И.Канту, опыт является единством	чувственности и рассудка верно
Согласно И.Канту, правдивость:	является безусловным долгом каждого вне зависимости от обстоятельств верно
Согласно И.Канту, существует три вида заинтересованного отношения человека к вещи. Какое из них он называет наиболее свободным?	прекрасное; то, что просто нравится
Согласно И.Канту, форма и условия восприятия объектов в пространстве:	находятся в душе человека изначально верно
Согласно И.Канту, человек есть:	конечная цель для самого себя
Согласно К. Марксу, религия является:	формой сознания, отражающей отчуждение в обществе эксплуатации
Согласно Канту, категорический императив исходит из	уважения к моральному закону
Согласно Л.Фейербаху, история религии есть ни что иное, как	история человека
Согласно Н.А. Бердяеву, противостояние философии и религии неслучайно потому, что	религия тоже включает в себя познание
Согласно Н.Луману, вместо религиозной морали в современном обществе перед человеком самым разнообразным способом ставит ориентиры и транслирует идеалы:	реклама
Согласно общей установке античности, познание природы, космоса, его порядка является:	высшей целью человека
Согласно Платону, «идеи» как предмет истинного знания:	вечны и неизменны
Согласно Платону, знание:	имеет своим предметом бытие с целью постичь, каково оно верно
Согласно Р. Ингардену, для эстетического восприятия	допустимо придумывать отсутствующие у объекта качества 
Согласно С.Л.Франку основным источником философского знания следует считать	целостный духовный опыт верно
Согласно Сартру, человек, это существо, обращенное в будущее. Это значит, что:	в своем существовании человек проецирует себя в будущее, человек – это проект верно
Согласно Т.Гоббсу, определение справедливости, данное схоластами, гласит, что она является:	волей дать каждому его собственность
Согласно Тейяр де Шардену, появление мышления следует рассматривать как:	важнейшее изменение состояние вселенной
Согласно Тейяр де Шардену, сводить всякую науку к вопросу о человеке целесообразно, потому что:	человек является центром конструирования универсума верно
Согласно терминологии Г.Риккерта, вещи сами по себе уже являются для нас:	благами
Согласно У. Эко, в 20-30-ее годы отношение массмедиа к идеалам Красоты характеризуется:	заимствованием идеалов, поставляемых элитарным искусством
Согласно Ф. Энегльсу, вопрос о соотношении мышления и бытия это, помимо прочего, вопрос о соотношении:	духа и природы
Согласно Ф.Энгельсу, наука первоначально смотрела на мир ограниченно, и подлинная философия помогает науке осознать и преодолеть проблему:	отсутствия понимания того, что и материя, и человеческое общество находятся в развитии верно
Согласно Ф.Энгельсу, потребность в деньгах возникает тогда, когда:	появляется товар, посредством которого оценивались все другие
Согласно Фейербаху, причиной возникновения религии стали:	все вышеперечисленное
Согласно феноменологии Э.Гуссерля, непосредственно нам даны:	не вещи, как они существуют сами по себе, а вещи как предметы нашего сознания верно
Согласно философу Соловьеву, общим для искусства и мистики не является	размышление
Согласно формулировке М.Шелера, человеческое существо можно назвать "аскетом", потому что:	человек становиться человеком благодаря некоторому принципу, противоположному жизни как таковой
Согласно Х. Ортега-и-Гассету, массовый человек связывает себя с государством, потому что	все перечисленные варианты верны
Согласно Х. Ортега-и-Гассету, цель существования человека	поиск высшего начала
Согласно Х.Ортега-и-Гассету, массы реализуют свою волю через	массовую культуру
Согласно Хайдеггеру, в новоевропейской метафизике возобладало не стремление к постижению истины самой по себе, а проблема:	правильности использования разума человека
Согласно Шелеру, изучение наиболее общих, междисциплинарных проблем естественных наук (понимание жизни, материи и т.п.) относится к:	к тому, что сам Шелер называл «метафизическим знанием» или «знанием ради спасения» верно
Согласно Э.Фромму, озабоченность болезнями, смертью и т.п. является:	проявлением «некрофилии», которая может быть и у молодого человека
Согласно Э.Фромму, самый важный шанс и преимущество старости в том, что:	человек может посвятить себя философским размышлениям
Соловьев указывает на то важное обстоятельство, что философия опирается на	чистый разум
Сосредоточенность на межличностном и межгрупповом взаимодействии, попытка осознать описываемые события и процессы глазами их участников	историческая антропология
Социальное расслоение возникает после того как появились излишки продукта, присваиваемые некоторыми общинниками. Это зависело от...	совершенствования технологий производства
Социальные катастрофы, войны, проблемы первой половины ХХ века лишили Европу и человечество иллюзии о том, что:	человеческий разум нравственен сам по себе и прогресс заключается в том, чтобы общество могло предоставить наибольшие возможности для реализации свободы
Социальный институт – это	все вышеперечисленное
Социальный номинализм предполагает, что общество является:	совокупностью людей, которые осуществляют действия под влиянием собственных интересов
Социогенез - это:	всё вышеперечисленное
Специфической особенностью современного периода взаимоотношений человека и природы является:	разработка проектов решения кризисных ситуаций в природоиспользования
Сравнивая слова «добро» и «желтый», Дж.Э.Мур ставит целью показать, что:	они оба являются простыми качествами
Субъективная и объективная реальность это	сознание и независящая от сознания реальность
Существование различных определений философии является следствием:	многообразия человеческого опыта верно
Существует следующая стратификационная система:	все вышеперечисленное
Сущность веры в единого бога в отличие от политеизма – веры во многих богов в том, по Фейербаху, что	в монотеизме человечество начинает осознавать себя как единый род существ
Т.Гоббс утверждает, что справедливость - это:	соблюдение интересов всех сторон в договоре
Такие разделы философии, как философия истории, философия науки и техники, философская антропология, социальная философия обособились в отдельные дисциплины:	в конце XIX века – XX веке верно
Тезис Р.Декарта "я мыслю следовательно существую" указывает на то, что	истинность моего мышления несомненна
Термин «чистая доска» в эмпиризме Дж.Локка значит	человек не обладает никакими врожденными знаниями
Термин «экология» введен	Э.Г. Геккелем в книге «Общая морфология организмов»
Технологическая революция	качественное изменение в развитии техники, захватывающий всю культуру
То, что именно поэты, а не философы, являются подлинными хранителями «голоса бытия» и истины, считал:	М.Хайдеггер
То, что истины – это правила, способствующие успешной деятельности, полагает такая философская теория, как	прагматизм
То, что мир не познаваем, и поэтому нельзя знать, существует бог или нет, это	агностицизм
То, что многие философские направления в ХХ в. тесно переплетаются искусством, имеет причиной:	все вышеперечисленное верно
То, что ученый-естественник может начать заниматься философскими вопросами, объясняется, согласно Х. Ортега-и-Гассету:	самой природой естественных наук
Тоффлер является автором концепции технологического развития общества, которая выражена им в работе:	"Третья волна"
Точка зрения, согласно которой красота – не свойство предмета, а определенное отношение к нему, связано с такой категорией, как	вкус
Традиционный тип общества характеризуется	религиозной направленностью
Три основные формы понимания истории - космическая, эсхатологическая, фактическая. Но только фактическая может считаться историей в полном смысле слова, так как обладает всеми признаками этого миросозерцания, а именно	гуманистичностью, универсальностью, линейностью, закономерностью, самодостаточностью
Труд Мартина Хайдеггера, названный по одному из диалогов Платона, это	Парменид
У Хайдеггера понимание истины как aletheia непосредственно связано с	ролью человека, идущего навстречу истине верно
У Э. Тоффлера принципиальное отличие так называемой «Третьей волны» от предыдущих состоит в том, что:	эта волна начинается не с технологий, а с социально-экономических задач, которые стоят перед обществом
У. Бек говорил, что вместо подлинного многообразия, открытости и плюрализма распространяется единый набор символов изъятых из	из образов массового искусства
У. Бек полагает, что разрушение окружающей среды непосредственно связано с:	бедностью
У. Бек полагает, что само современное общество выработало практику, которая способна стать одним из средств предупреждения будущих глобальных проблем. Это:	публичность принятия решений
У. Бек призывает осознать единство человечества	перед лицом глобального экологического кризиса
У. Бек. полагает, что современное общество, в противоположность классовому, является обществом	риска
У.Эко находил возможность назвать «открытым произведением» и современное искусство, и современную рекламу, потому что	в современном искусстве и рекламе предполагается активная роль зрителями 
Уже в античной философии было осуществлено разделение на:	истину и мнение
Уже в античности, помимо обоснования знания, важной задачей философии стало:	определение правильного образа жизни верно
Узкая специализация работников и машинное производство характерны для такого периода развития техники, как	индустриальный
Укажите характеристику, не относящуюся к эстетическому опыту	всеобщий характер идей, представлений, которые этим опытом производятся
Укажите характеристику, не относящуюся к эстетическому опыту	данный опыт важен и ценен сам по себе
Указанный Максом Шелером парадокс теоретического познания сущности вещей состоит в том, что:	можно использовать в качестве примеров не реальные, а воображаемые вещи
Утверждение, что для эстетического опыта важна форма воспринимаемых нами чувственных данных, значит:	эстетический опыт образуется тогда, когда внимание обращается к тому, как представлены нам те или иные чувственные данные 
Утверждение, что религия отличается от нравственной философии только формально, принадлежит:	И. Канту
Учение о том, как в мире разворачивается и воплощается божественный план, и человечество неизбежно движется к Царству Божьему, называется:	провиденциализм
Учение, согласно которому различные социумы можно распределить в соответствии с уровнем их развития, относится к	эволюционизму
Ф. Фукуяма в 1993 году достаточно преждевременно объявил о 	конце истории
Ф. Энгельс показывает, что в период Нового времени самым важным фактором развиия философии, в том числе спора материализма и идеализма, стали:	естественные науки
Ф. Энгельс сомневался в возможности построения целостной и окончательной научной модели мира, потому что	наши знания обусловлены обстоятельствами их получения
Ф.Бэкон различал четыре рода “идолов”, один из которых:	идол пещеры
Ф.Энгельс приводит пример «родового» строя. Это:	индейцы Америки
Фейербах формулирует важнейшую цель своего изучения религии как:	содействие свободе человека
Философ роман ингарден был представителем	феноменолагической эстетики
Философами и культурологами, исследовавшими медиареальность, были	ни один из них
Философия медиа исследует	изменения культуры которые были вызваны появлением новых средств коммуникаций
Философия является наукой потому что:	знание рассматривается философией как ориентир и высший идеал
Философом, по Платону, следует считать того, кто	ценит все существующее само по себе
Философская антропология может претендовать на статус важнейшей философской дисциплины, когда	накапливается багаж знаний о человеке, его месте в мире и природе
Философский понятийный аппарат для религиозного осмысления мира использует:	религиозная философия
Философский смысл деизма Нового времени в том, что	законы природы постоянны и неизменны
Философы Нового времени (Р.Декарт, Ф.Бэкон и др.) установили, что в идеал научного знания входит:	все вышеперечисленное
Фихте является автором первой философии истории в полном смысле этого слова, которую он озагалавил:	"основные черты современной эпохи"
Франк написал исследование по социальной философии, которое называется	духовные основы общества
Франк считает, что смысл истории может быть реализован только в том случае, если:	каждая эпоха имеет свое значение, а также является творцом и проводником этого смысла
Франк утверждает, что:	человечество способно осознать себя на любой стадии истории верно
Х. Ортега-и-Гассет полагал, что философские вопросы выступают:	ориентиром развития европейской науки и культуры
Христианское линейное понимание времени и истории сохраняло свое влияние очень долго. До какого времени?	до эпохи Просвещения
Целостность человеческого труда в доиндустриальную эпоху в том, что субъект труда	сам выполняет все действия, необходимые для получения завершенного изделия
Центральным в этике И.Канта стало понятие	долг
Цицерон в одном из своих сочинений прямо ссылается на Аристотеля и на его этику, используя понятие «моральная философия». Это сочинение:	«О судьбе»
Частная индивидуальная собственность получила распространение начиная с...	XVIII века
Человек был элементом природы/хаоса в античной истории, сама же она была историей свершающегося постоянно Космоса. В силу этого античная история:	циклична и космична
Человеку необходимо обрести свое место. Христианство требует для этого человека	смирения
Человеку, стремящемуся иметь обоснованное представление о природе и сущности мира, следует, по Шелеру, опираться на:	позитивные данные естественных наук
Что из нижеперечисленного, по мнению М.Шелера, радикально отличает человека от всего остального живого мира:	разум, дух
Что понимается под нарративом чаще всего?	конкретная интерпретация определённого события
Чтобы исключить установку на то, что нам даны вещи, независимые от нашего сознания, Э.Гуссерль предлагает процедуру:	 фенеменологической редукции
Э. Тоффлер утверждает, что современные ему новые технологии должны подвергнуться следующим тестам	все вышеперечисленное
Э. Фромм критически относится к установке, распространенной в 20 в. на Западе, что свобода отдельного человека, по сути, это:	потребление
Эволюционизм как теория может сочетаться с	всем вышеперечисленным верно
Элементом эстетического сознания является:	все вышеперечисленное верно
Элементы ритуальности, мистериальности У. Эко видит в	во всем вышеперечисленном
Энгельс пишет, что первым возникшим классом, который появился с возникновением цивилизации, и не был напрямую связан с производством, был:	класс купцов
Эпистемология – это философская наука о:	знании
Эссе Эриха Фромма называется:	"психологические проблемы старения"
Эстетика как философская наука исследует 	все вышеперечисленное
Эстетическая реакция, реакция на эстетический опыт может принимать:	вербальные и невербальные формы 
Эстетические реакции, выраженные в форме восклицаний «Ах!» и «Это прекрасно!» с точки зрения содержания отличаются тем, что:	одна из них содержит слова, термины, давно ставшие эстетическими категориями («прекрасное»), а другая – нет
Эстетический опыт ближе всего к такому типу опыта, как	опыт любви
Эсхатологическое понимание истории было предложено	Августином Аврелием в 5 веке 
Этика Аристотеля как наука о высшем благе в общефилософском смысле изучает	средства для достижения счастья
Этическая категория, с которой непосредственно связано понятие свободы	ответсвенность
Этическое содержание, по Й.Хейзинге, придает игре:	напряжение
Этическое сочинение "Метафизика нравов" принадлежит перу немецкого философа...	И.Канта